1 ContributorNew Music Friday 04/21/23 LyricsGrupo Frontera - un x100to
The Weeknd - Double Fantasy (with Future)
Ed Sheeran - Boat
Latto - Put It On Da Floor
Moneybagg Yo - Motion God
Kim Petras - Alone (with Nicki Minaj)
Christine and the Queens - True love (feat. 070 Shake)
Foo Fighters - Rescued
MUNA - One That Got Away
YoungBoy Never Broke Again - What You Say (feat. Post Malone & The Kid LAROI)
The Chainsmokers - Up & Down
Ti√´sto - Chills (LA Hills)
Chris Lake - Beggin'
Feid - Ni√±a Bonita
The Kid LAROI - WHERE DOES YOUR SPIRIT GO?
iann dior - start again
Arlo Parks - Blades
Bree Runway - Be The One (with Khalid)
Peso Pluma - Rosa Pastel
Bebe Rexha - Satellite
Florence + Th–µ Machine - Mermaids
AJR - The Dumb Song
Agust D - Ha–µgeum
Q - UNDERSTAND (feat. Baby Rose)
Mac DeMarco - 20200817 Proud True Toyota
Old Dominion - I Should Have Married You
Jackson Wang - Slow (with Ciara)
Rita Ora - Praising You (feat. Fatboy Slim)
Iniko - Jericho
VIC MENSA - $WISH ft. G-Eazy and Chance The Rapper
Armani White - SILVER TOOTH. (with A$AP Ferg)
Olamide - Trumpet
Joy Oladokun - Taking Things For Granted
Gus Dapperton - Don't Let Me Down
corook - if i were a fish (feat. Olivia Barton)
Sofi Tukker - Jacar√©
Goth Babe - Alone in the Mountains
Alanis Morissette - You Oughta Know (feat. Ingrid Andress, Lainey Wilson, Madeline Edwards, Morgan Wade) - Spotify Singles
Morgan Evans - Hey Little Mama
Nicki Nicole - qu√© le pasa conmigo?
DDG - I'm Geekin
Swizz Beatz - Say Less (feat. Lil Durk & A Boogie Wit da Hoodie)
Belly - American Nightmare
Ari Abdul - You
Dreamer Isioma - Gimmie A Chance
joan - superglue
Madison Ryann Ward - A New Thingüïí
The Japanese House - Sad to Breathe
it's murph - Youthful Kids
Godly the Ruler - revenge
Yng Lvcas - Perdon√©monos
Tee Grizzley - B&E Pt. 1
Mike Dimes - OFF THE PORCH (feat. BigXthaPlug & Maxo Kream)
Jack Kays - Highlight Reel
Sleep Token - DYWTYLM
The Band CAMINO - What Am I Missing?
Barns Courtney - Golden
Verzache - Never Gets Old‚òëÔ∏è
JON VINYL - No Feelings
Peezy - FW That
Killer Mike - Don't Let The Devil (Feat. thankugoodsir)
Wisin - MI EXXX
Rudimental - Dancing is Healing
SBTRKT - L.F.O.
New West - in my city
PawPaw Rod - Is It Magic?
Roy Woods - Young Boy Problems
Astrid S - Darkest Hour
Thomas Day - MASOCHIST
Madelline - dopamine
JORDY - Good Not Great
IDK - Mr. Police
redveil - captain
Sam Austins - Oatmeal Pancakes
bludnymph - Watch Me
Charlotte de Witte - High Street - Editüêö
Spiritbox - The Void
Rancid - Tomorrow Never Comes
Mas Musiq - Nini Nannini feat. Daliwonga & Howard Gombaüïí
Heembeezy - Beat The Yacci (feat. Blueface & Mike Crook)üêö
Kid Ink - LTW‚òëÔ∏è
Kim Loaiza - Kitty
Rodrigo y Gabriela - True Nature
The Last Dinner Party - Nothing Matters
Leith Ross - Music Box
St. Paul & The Broken Bones - Oporto-Madrid Blvd
Hunter Hayes - Feelings
Tenille Townes - Home to Me
Frawley - Crying My Eyes Out
Wrabel - feel it now (alive)
Superviolet - Dream Dating
George FitzGerald - Mother
The Used - Numb
Bella White - Numbers
Nep - Rocket Ship
Loren Gray - Enough For You
sophie meiers - okay w/ that
Dave Matthews Band - Monsters
Buju Banton - High Life
PGF Nuk - The NextEmbed