1 ContributorRapCaviar 5/7/2020 LyricsTHE SCOTTS - THE SCOTTS, Travis Scott and Kid Cudi
ROCKSTAR - DaBaby and Roddy Ricch
Toosie Slide - Drake
Walk Em Down - NLE Choppa and Roddy Ricch
Savage Remix - Megan Thee Stallion and Beyonce
Righteous - Juice WRLD
WHATS POPPIN - Jack Harlow
Demons - Drake, Fivio Foreign and Sosa Geek
Broke In A Minute - Tory Lanez
PTSD - G Herbo, Juice WRLD, Chance the Rapper and Lil Uzi Vert
P2 - Lil Uzi Vert
Turks - NAV, Gunna and Travis Scott
High Fashion - Roddy Ricch and Mustard
Blueberry Faygo - Lil Mosey
PICK UP - DaBaby and Quavo
Myron - Lil Uzi Vert
After Party - Don Toliver
Suicidal Remix - YNW Melly and Juice WRLD
Emotionally Scarred - Lil Baby
Pain 1993 - Drake and Playboi Carti
The Box - Roddy Ricch
Numbers - A Boogie Wit da Hoodie, London On Da Track, Roddy Ricch and Gunna
Oprah's Bank Account - Lil Yachty, DaBaby and Drake
FIND MY WAY - DaBaby
Life Is Good Remix - Future, Drake, Lil Baby and DaBaby
Dior Remix - Pop Smoke and Gunna
Heatin Up - Lil Baby and Gunna
Havin My Way - Lil Skies and Lil Durk
Out Of Love - Lil Tecca and Internet Money
Heart On Ice - Rod Wave
Lo Mein - Lil Uzi Vert
Lil Top - YoungBoy Never Broke Again
Commercial - Lil Baby and Lil Uzi Vert
SKYBOX - Gunna
Go Stupid - Polo G, Stunna 4 Vegas, NLE Choppa and Mike WiLL Made-It
Nawfside - YoungBoy Never Broke Again
2 Seater - YBN Nahmir, G-Eazy and Offset
DND - Polo G
The War - Joyner Lucas and Young Thug
Moana - G-Eazy and Jack Harlow
@ MEH - Playboi Carti
Need Me - J.I the Prince of N.Y
Yikes - Nicki Minaj
Stupid Again - Tory Lanez
Cardigan - Don Toliver
We Paid - Lil Baby and 42 Dugg
I Spy - Tee Grizzley
Ice Cold - Lil Tjay
Viral Moment - Lil Durk
Wetty - Fivio ForeignYou might also likeEmbed